  *     *     * *  **    ***** **       **   **  * *  ** *    * ** *        * **
        * *    * *     *    **  *    * * **  *   *   *** * * *       *     * *  
  *   **  * **  *   ****    ***      **  * *      *  *         * *      *     * 
*   *        *     * *  *    *  **           *      *   *        *  *     * **  
 * *   ***  *       * **  * *  **      **   *  * *  * *  ***    *     *        *
        *  **        * *    *** *  *  ***   *     *    * ** *     * ** *  ** ***
*      ***    **  ***  *  ***    * *       *   *  * *    * * *      **  *   *   
* *  *        * ** **       **      *   *     *  * ***    **   *     *        * 
  **  *       **   ** **            *    * *    *      **     *    *       * ** 
  *  **  *        *    *          *   * * **          ** * *    *  * *  **     *
 *   *   ** * **   ** * *   *  ** *         *** *        **  *      * * **  **  
* * *           * *   *  ***      *  *  *   *  * *  * **** * * *      ** **     
     *** ***  *** *  ** * *   *     *  *    **      *        * **            ** 
  *  *    ***  *   *         *  *   ** * **  **        * **      *       *** *  
     ***    * *  ***   *           ** *    *  *     * * *        ******   * **  
     *       *  *** *  * *     **        **  *      * *      *  *     * **      
  * **      **  *   *     *     *  *   * *       *     **     *  **  *  *     * 
  * *       *   **** * *       *    * * ** *  * **    ** *      * **   *   *   *
* *          * **     *      *  *         *    *     *    *       *  *** *   ***
    * *  * *       **  *      * *    ** *   * **     ***     ** *****  *        
***  * *  *    *   *  *         ** * *   * *  *  * * * *  * *          *  *   * 
   * ***       * *         *  *              *    * *   *    * *  *  * * *     *
 *  *    * * *  *     *******     *  *    * *  *  * **         ** * *  * **     
***                **   *    *    **           *   ***     * *  * * *  *  *  * *
*    * **       *      *** *   *       ***     ***  *   *  *** **       * *    *
 *  *    **     ** *     * *  *  *      *  *  *       **    *    ***   *  **    
  * *   ** *    *         *  *                 ** * *  * * * ***      *         
 *  * *   *     * ***  * ****  *  ****  **     *  **  *  *  **  *       *       
 ***         *   *        *  ***  *   * * *  *  *    * *** *  * **   *   **    *
  *   **    ** ** *    ***      * **   ***       * *            **    * *  **   
  *  *  **     *** *  *    *     * * *  * *  *  **** *     *    *     *  *      
       * **   ** *                *  **   ***     *  *      *    *   *  ***     
         * *   ** * *****     *  *   **  *    * * *    **     *       *  *  *  *
* *            * *    *  ***  **       ***   **  * ** *  *   **   *  *  *     * 
 ** * *    **  **   ***** ** * *   **    **     *  **   *     *   * **        * 
       **      *** *  **   ****       *   * *     *  *   *** *++++++++++++++    
 *  * *           *  * * ***  *    *  *           *    ** +++++** *     * *+*** 
              * ** * *  ** * ****   **  *    *  **    * +++*  *     *  * **G    
 *  * *  +++++**      *     ***  **         **  ** * * *+* *  * *    * *  * *   
 *  *    +*  ++++++++++  *  * * *** ** * *   *+++++++++++  * * *      **       *
*   ++++++** *   * ** +**  * *   *   * * * *+++ * * *      ***    * ***  ***** *
*** +***    *   * *   ++++*   *   *   **+++++   *   *   *  **    ***   *  *  *  
    ++I ****           * +++++++* ***++++ *     *   * * * **    *    *  **    * 
 *       *    ****          ***+++++++ *    *  *            * *  *  *    * *  **
* **      **    ** *  *    **      *       ** *  *       *** ***  * *      *    
  *    * ***             *   ****   **  ** *  *     * ** *  *  *  *   **  ***  *
       * *  *      *   *     * *    *              * ***     * **   **  *  *    
 *    *****   * * *  *** * *              *  *   * **   *  ****   *          *  
      ** **  *  *  * ****   *   * * *  *  * **** *  *    * * ***  *  * *  *   * 
 *   ** *** *      **    *      *   * * * *          * **  * **    *  * ** *    
* *   *  *  *         * * **     **    ***       **    *        * ****     *    
 ***        *          * *   *  *      * ** *          * *       **  * **  *    
 *  *      * *  * **   *     ***     ** *  *  * *  *      *          *        * 
* * * **      *  *    * ** *     ***  *       *    *  * *    **   * *      **  *
** * *   *    *      *  **    **   *   *    *    ***    ** * *   **     *      *
   * * *     *   *     ***** **        **  *  ** *      *      *  *  *       *  
  *     * **  ** *   *     *       * * *     ** *   *  *        *   *  *     *  
 * *  * * *  * *** *   * *   *    **  *     *    *    *        *    **          
           *   *  **        *   *       **   ****   *  *      *     ***  * *   *
 ** *           *    *     **           *  **       *  *    **     **   *  *    

